****************
*              *
*              *
*              *
*              *
*              *
*  G **       **
*    **        *
*              *
****           *
*              *
*              *
*         *    *
*         *    *
*P        *    *
****************
