****************
*           *  *
**             *
*              *
*              *
*              *
*      G       *
*              *
*              *
*              *
*    ******    *
*    *      P  *
*              *
*             **
*    *         *
****************