****************
*            * *
*              *
*              *
* *   G **     *
* *  ****      *
* *        *   *
*          **  *
*          **  *
*    P         *
*          **  *
* **           *
* **           *
*  *           *
*             **
****************