****************
*              *
*    G         *
**             *
**            **
*     ***      *
*              *
*              *
***            *
**      *     P*
*       *      *
*              *
*              *
*             **
*           ****
****************