****************
*              *
*              *
*         G  * *
*   **  **  ** *
*   **  **  ** *
*              *
*     P        *
*   **  **     *
*   **  **     *
*           ** *
*   **  **  ** *
*   **         *
*            ***
*            ***
****************