****************
*              *
*              *
*              *
*              *
*              *
*              *
*G             *
*              *
*              *
*              *
*              *
*              *
*              *
*P             *
****************