****************
*              *
*              *
*            G *
*     **       *
*      *       *
**             *
**             *
**             *
*       **     *
*        *     *
* ****         *
*   *          *
*        *    **
*P       *     *
****************