****************
*       *  *   *
*   G   *  *   *
*       *      *
**      *     **
*              *
*              *
*       P      *
*              *
*              *
*              *
*              *
*              *
*             **
*             **
****************