****************
*              *
*              *
***      ** G  *
***       *    *
*    *         *
*    *         *
*    *         *
*   **         *
*          **  *
*  P        ** *
*    ****      *
*              *
*              *
*  *          **
****************