****************
**            P*
**      *      *
**      *      *
*       * G    *
*       *      *
*   *          *
*   *   *   *  *
*   *          *
*              *
*     *       **
*     *        *
*              *
*              *
*              *
****************